wwwwwwwwwwwwwwwwwwwww
w w   w w w         w
w w www w w www wwwww
w             w     w
w w wwwww www w www w
w w     w   w w   w w
w www w w wwwwwww www
w   w w w       w   w
w w www wwwww www www
w w   w w       w   w
www wwwwwww w wwwwwww
w     w w   w       w
w w w w w w w wwwww w
w w w   w w w   w w w
wwwww w w w w www www
w     w w w w w     w
w w w www www w w www
w w w w   w     w   w
www w w w w w w wwwww
w   w w w w w w     w
wwwwwwwwwwwwwwwwwwwww